9.ox
oo.oo..o.
oo..o...o
.ooo.....
.o....oo.
...o...oo
oo.....oo
o..o.....
ooo....oo
..o.o...o
