10.ox
..........
....\.....
.........\
.\.....\.\
..\\\....\
.\.\.....\
..\....\..
....\.....
...\..\...
..........
